CSS 속성
1) 단위속성 : px // % // em // rem// vw // vh // max
2) 색상속성 : rgb // rgba // hex
3) 가시속성 : display // v
4) 박스속성 : box - sizing
5) 테두리속성 : boder //
6) 배경속성 : background - color //
7) 폰트속성 :  font - size // 
8) 위치속성 :
 - static :  정적인 // 움직임에 대한 변수가 존재
어떤 태그를 작성하던가에 기본적인 속성은 position: static;

 - relative : 상대적인 // 자식

 - absoiute :  절대적인 // 만약 부모 요소 중 그 누구도 relative 속성ㅇ르 가지고 있지 않은 경우 최상위 루트 태그를 중심으로 절대 위치좌표 값을 갖게된다. 만약 부모 부모중 relative 속성을 갖고있다면 해당 부모를 기준으로 절대 위치값을 갖게됨

 - fixed : 고정된 // 주로 쇼핑몰내에 날개배너 같이 특정 ㅠㅗ지션에 고정되어서 사용됨

 - sticky : 끈적한 // 스티커 // 끈적 X 
평상시에는 스티커처럼 작동하다가 특정위치 좌표에 도팍하는 순간 마피 쓴쓴한 스티커



9) float : 부유하다 // 표류하다
  -> 타블로이드 형식 레이아웃을 정렬해야하는 








상향식 방식 : 
작은 단위에서 큰 단위로 점진적 구조화

gmb : gloder navigattion benner
> 재품 서비스의 메인 네비게이션 // 전역

lnb : local navigattion benner // 지역


strog = inline 
인라인 블럭으로 바꾸기

white-space: norap; = 휜여백
overflow: hidden; = 부모요소 나가는거 가리기
text-overflow: ellipsis; = 글자가 길어서 가려질떄 말 줄임표 표시 ...

Ddployment 배포

server : 타인에게 내가 만든 웹 페이지 정보를 보여주기 위해서 원격의 공간 // 사적인 공간(나만 볼 수 있는 공간) 에 저장을 해야하는데 그 공간을 서버


- Google firebase : Node.js먼저 설치

- netifiy

- github

- cafe 24
- fly.io
- heroku
.....

Hosting : 로컬 컴퓨터에 읶는 Data를 Sever로 전달하도록 하는 행위

















